NO ./srcs/textures/teo.xpm
SO ./srcs/textures/texS.xpm
WE ./srcs/textures/texW_pumpkin.xpm
EA ./srcs/textures/texE_bee.xpm

F  187,185,13   
C  234,91,227 

 111111
110N0011
 1000001
 1000011
 1000W01    
 1S00001
 10010011
 1000001    
 1000E01  
 1111111
 11 11
